NO ./test_textures/barrel.png
SO ./test_textures/barrel.png
WE ./test_textures/barrel.png
EA ./test_textures/barrel.png

F 0,0,0
C 0,0,0
11111
20004
2N004
20004
33333