NO ./test_textures/barrel.png
SO ./test_textures/barrel.png
WE ./test_textures/barrel.png
EA ./test_textures/barrel.png

F 220,100,0
C 225,30,0

11111   1111111111111111111111111
10001   1000000000110000000000001
10001   10110000011100000000001111111
10001    1111001000000000000000000001
11111111101100000111000000000000111111
100000000011000001110111111111111
11110111111111011100000010001
1111011111111 1011101010010001
1100000011N101011100000010001
10000000001000001100000010001
10000000000000001101010010001
1100000111010101111101111000111
1111011 1110101 1011110100001
11111111 1111111 11111111111