NO ./test_textures/barrel.png
SO ./test_textures/barrel.png
WE ./test_textures/barrel.png
EA ./test_textures/barrel.png

F 200 125,0
C 255,255,0

        1111111111111111111111111
        100000000111000000000001
        1011000001110000000000001
        1001000000000000000000001
111111111111000001110000000000001
100000000011000001110111111111111
1111011111E111011100000010001
11110111111111011101010010001
11000000110101011100000010001
10000000000100001100000010001
10000000000000001101010010001
1100000111010101111101111000111
11110111 1110101 101111010001
11111111 1111111 111111111111
11111111111111111111111111111