NO ./textures/purplestone.png
SO ./textures/yellow-wall.png
WE ./textures/stars.png
EA ./textures/red_wall.png

F 220,100,0
C 22,30,0
                                         11111
                                        11000111111111
11111111111111111                       11000000000001
100000000000000011111111111111111111111111000000000001
101000001000001000000000000000000000000000000000000001
100000000000000011111111111111111111111111111111011111
10001000100010001                              101
10000000000000001                              101111111111111111
10101010N01010101                              100000000000000001
10000000000000001                              111111111111111101
10001000100100001                                             101
10000000000000001                                             101
10100000100001001                                             101
10000000000000001                                             101
11111011111111111                                             101
    101                                                       101
11111011111111111                                             101
10000000000000001                                             101
10100000100000101                                             101
10000000000000001111111111111111111111111111111111111111111111101
10001000100010000000000000000000000000000000000000000000000000001
10000000000000001111111111111111111111111111111111111111111111111
10101010001010101
10000000000000001
10001000100100001
10000000000000001
10100000100001001
10000000000000001
11111111111111111