NO ./textures/skyline1.png
SO ./textures/stone-wall.png
WE ./textures/barrel.png
EA ./textures/barrel.png

F 220,100,0
C 22,30,0
1111
1001
10N1
1111