NO ./textures/north
SO ./textures/south
WE ./textures/west
EA ./textures/east

F 220,100,0
C 22,30,0

1111
1001
1001
1111